10001000000000100011
10001110000001001000
00100000001100010101
11111111111111111111
11111111111111111111
11111111111111111111
00110000011000000001
01000100010000011000
00100000000000101010
00010001101000100000