11111111000001111111
10001110000001111111
00100000001100010101
11111111111111111111
11111111111111111111
11111111111111111111
00110000011000000001
11110100010000011000
11110000000000111111
00010001101000100000
