01000100000001000001
11111000100110000010
00001101011111011000
00101101000000011100
11100001000100111100
10101111011100111100
00000000001000111100
11110010010100000000
11100101000101010101
00000010000000101110