00101011101010101001
00000000000000000001
10100000010111110011
00001100111001010001
00011100110001010000
00001100000000000010
00000000000010000000
10100000100101110001
10000001010000001000
10001000000111110011