00010111010010000100
01010000110001010110
10000000000000000100
01001001100010001110
00101101001101000000
01001000100010101000
10101100000011000010
01100000100000011000
10010010100101010010
01010111000000000001